0 20 20 test
0 0 0 0 0 0 0 0 0 0 0 0 0 0 0 0 0 0 0 0
0 0 1 0 1 0 1 0 1 0 1 0 1 0 1 0 1 0 1 0
0 1 3 3 3 1 0 1 0 1 0 1 0 1 0 1 0 1 0 0
0 0 3 3 3 0 1 0 1 0 1 0 1 0 1 0 1 0 1 0
0 1 3 3 3 3 3 3 3 3 3 3 3 3 3 3 3 3 0 0
0 0 1 0 1 0 1 0 1 0 1 0 1 0 1 0 1 0 1 0
0 1 0 1 0 1 0 1 0 1 0 1 0 1 0 1 0 1 0 0
0 0 1 0 1 0 1 0 1 0 1 0 1 0 1 0 1 0 1 0
0 1 0 1 0 1 0 1 0 1 0 1 0 1 0 1 0 1 0 0
0 0 1 0 1 0 1 0 1 0 1 0 1 0 1 0 1 0 1 0
0 1 0 1 0 1 0 1 0 1 0 1 0 1 0 1 0 1 0 0
0 0 1 0 1 0 1 0 1 0 1 0 1 0 1 0 1 0 1 0
0 1 0 1 0 1 0 1 0 1 0 1 0 1 0 1 0 1 0 0
0 0 1 0 1 0 1 0 1 0 1 0 1 0 1 0 1 0 1 0
0 1 0 1 0 1 0 1 0 1 0 1 0 1 0 1 0 1 0 0
0 0 1 0 1 0 1 0 1 0 1 0 1 0 1 0 1 0 1 0
0 1 0 1 0 1 0 1 0 1 0 1 0 1 0 1 0 1 0 0
0 0 1 0 1 0 1 0 1 0 1 0 1 0 1 0 1 0 1 0
0 1 0 1 0 1 0 1 0 1 0 1 0 1 0 1 0 1 0 0
0 0 0 0 0 0 0 0 0 0 0 0 0 0 0 0 0 0 0 0

4 64 64 4 64 64 4 64 64 4 64 64 4 64 64 4 64 64 4 64 64 4 64 64 4 64 64 4 64 64 4 64 64 4 64 64 4 64 64 4 64 64 4 64 64 4 64 64 4 64 64 4 64 64 4 64 64 4 64 64
4 64 64 0 64 64 0 64 64 0 64 64 0 64 64 0 64 64 0 64 64 0 64 64 0 64 64 0 64 64 0 64 64 0 64 64 0 64 64 0 64 64 0 64 64 0 64 64 0 64 64 0 64 64 0 64 64 4 64 64
4 64 64 0 64 64 4 64 64 4 64 64 4 64 64 0 64 64 0 64 64 0 64 64 0 64 64 0 64 64 0 64 64 0 64 64 0 64 64 0 64 64 0 64 64 0 64 64 0 64 64 0 64 64 0 64 64 4 64 64
4 64 64 0 64 64 4 64 64 4 64 64 4 64 64 0 64 64 0 64 64 0 64 64 0 64 64 0 64 64 0 64 64 0 64 64 0 64 64 0 64 64 0 64 64 0 64 64 0 64 64 0 64 64 0 64 64 4 64 64
4 64 64 0 64 64 4 64 64 4 64 64 4 64 64 4 64 64 4 64 64 4 64 64 4 64 64 4 64 64 4 64 64 4 64 64 4 64 64 4 64 64 4 64 64 4 64 64 4 64 64 4 64 64 0 64 64 4 64 64
4 64 64 0 64 64 0 64 64 0 64 64 0 64 64 0 64 64 0 64 64 0 64 64 0 64 64 0 64 64 0 64 64 0 64 64 0 64 64 0 64 64 0 64 64 0 64 64 0 64 64 0 64 64 0 64 64 4 64 64
4 64 64 0 64 64 0 64 64 0 64 64 0 64 64 0 64 64 0 64 64 0 64 64 0 64 64 0 64 64 0 64 64 0 64 64 0 64 64 0 64 64 0 64 64 0 64 64 0 64 64 0 64 64 0 64 64 4 64 64
4 64 64 0 64 64 0 64 64 0 64 64 0 64 64 0 64 64 0 64 64 0 64 64 0 64 64 0 64 64 0 64 64 0 64 64 0 64 64 0 64 64 0 64 64 0 64 64 0 64 64 0 64 64 0 64 64 4 64 64
4 64 64 0 64 64 0 64 64 0 64 64 0 64 64 0 64 64 0 64 64 0 64 64 0 64 64 0 64 64 0 64 64 0 64 64 0 64 64 0 64 64 0 64 64 0 64 64 0 64 64 0 64 64 0 64 64 4 64 64
4 64 64 0 64 64 0 64 64 0 64 64 0 64 64 0 64 64 0 64 64 0 64 64 0 64 64 0 64 64 0 64 64 0 64 64 0 64 64 0 64 64 0 64 64 0 64 64 0 64 64 0 64 64 0 64 64 4 64 64
4 64 64 0 64 64 0 64 64 0 64 64 0 64 64 0 64 64 0 64 64 0 64 64 0 64 64 0 64 64 0 64 64 0 64 64 0 64 64 0 64 64 0 64 64 0 64 64 0 64 64 0 64 64 0 64 64 4 64 64
4 64 64 0 64 64 0 64 64 0 64 64 0 64 64 0 64 64 0 64 64 0 64 64 0 64 64 0 64 64 0 64 64 0 64 64 0 64 64 0 64 64 0 64 64 0 64 64 0 64 64 0 64 64 0 64 64 4 64 64
4 64 64 0 64 64 0 64 64 0 64 64 0 64 64 0 64 64 0 64 64 0 64 64 0 64 64 0 64 64 0 64 64 0 64 64 0 64 64 0 64 64 0 64 64 0 64 64 0 64 64 0 64 64 0 64 64 4 64 64
4 64 64 0 64 64 0 64 64 0 64 64 0 64 64 0 64 64 0 64 64 0 64 64 0 64 64 0 64 64 0 64 64 0 64 64 0 64 64 0 64 64 0 64 64 0 64 64 0 64 64 0 64 64 0 64 64 4 64 64
4 64 64 0 64 64 0 64 64 0 64 64 0 64 64 0 64 64 0 64 64 0 64 64 0 64 64 0 64 64 0 64 64 0 64 64 0 64 64 0 64 64 0 64 64 0 64 64 0 64 64 0 64 64 0 64 64 4 64 64
4 64 64 0 64 64 0 64 64 0 64 64 0 64 64 0 64 64 0 64 64 0 64 64 0 64 64 0 64 64 0 64 64 0 64 64 0 64 64 0 64 64 0 64 64 0 64 64 0 64 64 0 64 64 0 64 64 4 64 64
4 64 64 0 64 64 0 64 64 0 64 64 0 64 64 0 64 64 0 64 64 0 64 64 0 64 64 0 64 64 0 64 64 0 64 64 0 64 64 0 64 64 0 64 64 0 64 64 0 64 64 0 64 64 0 64 64 4 64 64
4 64 64 0 64 64 0 64 64 0 64 64 0 64 64 0 64 64 0 64 64 0 64 64 0 64 64 0 64 64 0 64 64 0 64 64 0 64 64 0 64 64 0 64 64 0 64 64 0 64 64 0 64 64 0 64 64 4 64 64
4 64 64 0 64 64 0 64 64 0 64 64 0 64 64 0 64 64 0 64 64 0 64 64 0 64 64 0 64 64 0 64 64 0 64 64 0 64 64 0 64 64 0 64 64 0 64 64 0 64 64 0 64 64 0 64 64 4 64 64
4 64 64 4 64 64 4 64 64 4 64 64 4 64 64 4 64 64 4 64 64 4 64 64 4 64 64 4 64 64 4 64 64 4 64 64 4 64 64 4 64 64 4 64 64 4 64 64 4 64 64 4 64 64 4 64 64 4 64 64