0 20 20 test
0 0 0 0 0 0 0 0 0 0 0 0 0 0 0 0 0 0 0 0
0 0 1 0 1 0 1 0 1 0 1 0 1 0 1 0 1 0 1 0
0 1 3 3 3 1 0 1 0 1 0 1 0 1 0 1 0 1 0 0
0 0 3 3 3 0 1 0 1 0 1 0 1 0 1 0 1 0 1 0
0 1 3 3 3 3 3 3 3 3 3 3 3 3 3 3 3 3 0 0
0 0 1 0 1 0 1 0 1 0 1 0 1 0 1 0 1 0 1 0
0 1 0 1 0 1 0 1 0 1 0 1 0 1 0 1 0 1 0 0
0 0 1 0 1 0 1 0 1 0 1 0 1 0 1 0 1 0 1 0
0 1 0 1 0 1 0 1 0 1 0 1 0 1 0 1 0 1 0 0
0 0 1 0 1 0 1 0 1 0 1 0 1 0 1 0 1 0 1 0
0 1 0 1 0 1 0 1 0 1 0 1 0 1 0 1 0 1 0 0
0 0 1 0 1 0 1 0 1 0 1 0 1 0 1 0 1 0 1 0
0 1 0 1 0 1 0 1 0 1 0 1 0 1 0 1 0 1 0 0
0 0 1 0 1 0 1 0 1 0 1 0 1 0 1 0 1 0 1 0
0 1 0 1 0 1 0 1 0 1 0 1 0 1 0 1 0 1 0 0
0 0 1 0 1 0 1 0 1 0 1 0 1 0 1 0 1 0 1 0
0 1 0 1 0 1 0 1 0 1 0 1 0 1 0 1 0 1 0 0
0 0 1 0 1 0 1 0 1 0 1 0 1 0 1 0 1 0 1 0
0 1 0 1 0 1 0 1 0 1 0 1 0 1 0 1 0 1 0 0
0 0 0 0 0 0 0 0 0 0 0 0 0 0 0 0 0 0 0 0

2 64 64 2 64 64 2 64 64 2 64 64 2 64 64 2 64 64 2 64 64 2 64 64 2 64 64 2 64 64 2 64 64 2 64 64 2 64 64 2 64 64 2 64 64 2 64 64 2 64 64 2 64 64 2 64 64 2 64 64
2 64 64 0 64 64 0 64 64 0 64 64 0 64 64 0 64 64 0 64 64 0 64 64 0 64 64 0 64 64 0 64 64 0 64 64 0 64 64 0 64 64 0 64 64 0 64 64 0 64 64 0 64 64 0 64 64 2 64 64
2 64 64 0 64 64 2 64 64 2 64 64 2 64 64 0 64 64 0 64 64 0 64 64 0 64 64 0 64 64 0 64 64 0 64 64 0 64 64 0 64 64 0 64 64 0 64 64 0 64 64 0 64 64 0 64 64 2 64 64
2 64 64 0 64 64 2 64 64 2 64 64 2 64 64 0 64 64 0 64 64 0 64 64 0 64 64 0 64 64 0 64 64 0 64 64 0 64 64 0 64 64 0 64 64 0 64 64 0 64 64 0 64 64 0 64 64 2 64 64
2 64 64 0 64 64 2 64 64 2 64 64 2 64 64 2 64 64 2 64 64 2 64 64 2 64 64 2 64 64 2 64 64 2 64 64 2 64 64 2 64 64 2 64 64 2 64 64 2 64 64 2 64 64 0 64 64 2 64 64
2 64 64 0 64 64 0 64 64 0 64 64 0 64 64 0 64 64 0 64 64 0 64 64 0 64 64 0 64 64 0 64 64 0 64 64 0 64 64 0 64 64 0 64 64 0 64 64 0 64 64 0 64 64 0 64 64 2 64 64
2 64 64 0 64 64 0 64 64 0 64 64 0 64 64 0 64 64 0 64 64 0 64 64 0 64 64 0 64 64 0 64 64 0 64 64 0 64 64 0 64 64 0 64 64 0 64 64 0 64 64 0 64 64 0 64 64 2 64 64
2 64 64 0 64 64 0 64 64 0 64 64 0 64 64 0 64 64 0 64 64 0 64 64 0 64 64 0 64 64 0 64 64 0 64 64 0 64 64 0 64 64 0 64 64 0 64 64 0 64 64 0 64 64 0 64 64 2 64 64
2 64 64 0 64 64 0 64 64 0 64 64 0 64 64 0 64 64 0 64 64 0 64 64 0 64 64 0 64 64 0 64 64 0 64 64 0 64 64 0 64 64 0 64 64 0 64 64 0 64 64 0 64 64 0 64 64 2 64 64
2 64 64 0 64 64 0 64 64 0 64 64 0 64 64 0 64 64 0 64 64 0 64 64 0 64 64 0 64 64 0 64 64 0 64 64 0 64 64 0 64 64 0 64 64 0 64 64 0 64 64 0 64 64 0 64 64 2 64 64
2 64 64 0 64 64 0 64 64 0 64 64 0 64 64 0 64 64 0 64 64 0 64 64 0 64 64 0 64 64 0 64 64 0 64 64 0 64 64 0 64 64 0 64 64 0 64 64 0 64 64 0 64 64 0 64 64 2 64 64
2 64 64 0 64 64 0 64 64 0 64 64 0 64 64 0 64 64 0 64 64 0 64 64 0 64 64 0 64 64 0 64 64 0 64 64 0 64 64 0 64 64 0 64 64 0 64 64 0 64 64 0 64 64 0 64 64 2 64 64
2 64 64 0 64 64 0 64 64 0 64 64 0 64 64 0 64 64 0 64 64 0 64 64 0 64 64 0 64 64 0 64 64 0 64 64 0 64 64 0 64 64 0 64 64 0 64 64 0 64 64 0 64 64 0 64 64 2 64 64
2 64 64 0 64 64 0 64 64 0 64 64 0 64 64 0 64 64 0 64 64 0 64 64 0 64 64 0 64 64 0 64 64 0 64 64 0 64 64 0 64 64 0 64 64 0 64 64 0 64 64 0 64 64 0 64 64 2 64 64
2 64 64 0 64 64 0 64 64 0 64 64 0 64 64 0 64 64 0 64 64 0 64 64 0 64 64 0 64 64 0 64 64 0 64 64 0 64 64 0 64 64 0 64 64 0 64 64 0 64 64 0 64 64 0 64 64 2 64 64
2 64 64 0 64 64 0 64 64 0 64 64 0 64 64 0 64 64 0 64 64 0 64 64 0 64 64 0 64 64 0 64 64 0 64 64 0 64 64 0 64 64 0 64 64 0 64 64 0 64 64 0 64 64 0 64 64 2 64 64
2 64 64 0 64 64 0 64 64 0 64 64 0 64 64 0 64 64 0 64 64 0 64 64 0 64 64 0 64 64 0 64 64 0 64 64 0 64 64 0 64 64 0 64 64 0 64 64 0 64 64 0 64 64 0 64 64 2 64 64
2 64 64 0 64 64 0 64 64 0 64 64 0 64 64 0 64 64 0 64 64 0 64 64 0 64 64 0 64 64 0 64 64 0 64 64 0 64 64 0 64 64 0 64 64 0 64 64 0 64 64 0 64 64 0 64 64 2 64 64
2 64 64 0 64 64 0 64 64 0 64 64 0 64 64 0 64 64 0 64 64 0 64 64 0 64 64 0 64 64 0 64 64 0 64 64 0 64 64 0 64 64 0 64 64 0 64 64 0 64 64 0 64 64 0 64 64 2 64 64
2 64 64 2 64 64 2 64 64 2 64 64 2 64 64 2 64 64 2 64 64 2 64 64 2 64 64 2 64 64 2 64 64 2 64 64 2 64 64 2 64 64 2 64 64 2 64 64 2 64 64 2 64 64 2 64 64 2 64 64