0 20 20 test
3 0 3 0 3 0 3 0 3 0 3 0 3 0 3 0 3 0 3 0
0 3 0 3 0 3 0 3 0 3 0 3 0 3 0 3 0 3 0 3
3 0 3 0 3 0 3 0 3 0 3 0 3 0 3 0 3 0 3 0
0 3 0 3 0 3 0 3 0 3 0 3 0 3 0 3 0 3 0 3
3 0 3 0 3 0 3 0 3 0 3 0 3 0 3 0 3 0 3 0
0 3 0 3 0 3 0 3 0 3 0 3 0 3 0 3 0 3 0 3
3 0 3 0 3 0 3 0 3 0 3 0 3 0 3 0 3 0 3 0
0 3 0 3 0 3 0 3 0 3 0 3 0 3 0 3 0 3 0 3
3 0 3 0 3 0 3 0 3 0 3 0 3 0 3 0 3 0 3 0
0 3 0 3 0 3 0 3 0 3 0 3 0 3 0 3 0 3 0 3
3 0 3 0 3 0 3 0 3 0 3 0 3 0 3 0 3 0 3 0
0 3 0 3 0 3 0 3 0 3 0 3 0 3 0 3 0 3 0 3
3 0 3 0 3 0 3 0 3 0 3 0 3 0 3 0 3 0 3 0
0 3 0 3 0 3 0 3 0 3 0 3 0 3 0 3 0 3 0 3
3 0 3 0 3 4 4 0 3 0 3 0 3 0 3 0 3 0 3 0
0 3 0 3 0 4 5 3 0 3 0 3 0 3 0 3 0 3 0 3
3 0 3 0 3 0 3 0 3 0 3 0 3 0 3 0 3 0 3 0
0 3 0 3 0 3 0 3 0 3 0 3 0 3 0 3 0 3 0 3
3 0 3 0 3 0 3 0 3 0 3 0 3 0 3 0 3 0 3 0
0 3 0 3 0 3 0 3 0 3 0 3 0 3 0 3 0 3 0 3

5 5 5 5 5 5 5 5 5 5 5 5 5 5 5 5 5 5 5 5 
5 0 0 0 0 0 0 0 0 0 0 0 0 0 0 0 0 0 0 5 
5 0 0 5 5 0 0 0 0 0 0 0 0 0 0 0 0 0 0 5 
5 0 5 5 5 0 0 0 0 0 0 0 0 0 0 0 0 0 0 5 
5 0 5 5 5 5 5 5 5 5 0 0 5 5 5 5 5 5 0 5 
5 0 0 0 0 0 0 0 0 0 0 0 0 0 0 0 0 0 0 5 
5 0 0 0 0 0 0 0 0 0 0 0 0 0 0 0 0 0 0 5 
5 0 0 0 0 0 0 0 0 0 0 0 0 0 0 0 0 0 0 5 
5 0 0 0 0 0 0 0 0 0 0 0 0 0 0 0 0 0 0 5 
5 0 0 0 0 0 0 0 0 0 0 0 0 0 0 0 0 0 0 5 
5 0 5 5 0 0 0 0 0 0 0 0 0 0 0 0 0 0 0 5 
5 0 5 0 0 0 0 0 0 0 0 0 0 0 0 0 0 0 0 5 
5 0 0 0 0 0 0 0 0 0 0 0 0 0 0 0 0 0 0 5 
5 0 0 0 0 0 0 0 0 0 0 0 0 0 0 0 0 0 0 5 
5 0 0 0 0 0 5 0 0 0 0 0 0 0 0 0 0 0 0 5 
5 0 0 0 0 5 0 0 0 0 0 0 0 0 0 0 0 0 0 5 
5 0 0 0 0 0 0 0 0 0 0 0 0 0 0 0 0 0 0 5 
5 0 0 0 0 0 0 0 0 0 0 0 0 0 0 0 0 0 0 5 
5 0 0 0 0 0 0 0 0 0 0 0 0 0 0 0 0 0 0 5 
5 5 5 5 5 5 5 5 5 5 5 5 5 5 5 5 5 5 5 5 