0 20 20 castillo
1 1 1 1 1 1 1 1 1 1 1 1 1 1 1 1 1 1 1 1
1 1 1 1 1 1 1 1 1 1 1 1 1 1 1 1 1 1 1 1
1 1 1 1 1 1 1 1 1 1 1 1 1 1 1 1 1 1 1 1
1 1 1 1 1 1 1 1 1 1 1 1 1 1 1 1 1 1 1 1
1 1 1 1 1 1 1 1 1 1 1 1 1 1 1 1 1 1 1 1
1 1 1 1 1 1 1 1 1 1 1 1 1 1 1 1 1 1 1 1
1 1 1 1 1 1 1 1 1 1 1 1 1 1 1 1 1 1 1 1
1 1 1 1 1 1 1 1 1 1 1 1 1 1 1 1 1 1 1 1
1 1 1 1 1 1 1 1 1 1 1 1 1 1 1 1 1 1 1 1
1 1 1 1 1 1 1 1 1 1 1 1 1 1 1 1 1 1 1 1
1 1 1 1 1 1 1 1 1 1 1 1 1 1 1 1 1 1 1 1
1 1 1 1 1 1 1 1 1 1 1 1 1 1 1 1 1 1 1 1
1 1 1 1 1 1 1 1 1 1 1 1 1 1 1 1 1 1 1 1
1 1 1 1 1 1 1 1 1 1 1 1 1 1 1 1 1 1 1 1
1 1 1 1 1 1 1 1 1 1 1 1 1 1 1 1 1 1 1 1
1 1 1 1 1 1 1 1 1 1 1 1 1 1 1 1 1 1 1 1
1 1 1 1 1 1 1 1 1 1 1 1 1 1 1 1 1 1 1 1
1 1 1 1 1 1 1 1 1 1 1 1 1 1 1 1 1 1 1 1
1 1 1 1 1 1 1 1 1 1 1 1 1 1 1 1 1 1 1 1
1 1 1 1 1 1 1 1 1 1 1 1 1 1 1 1 1 1 1 1

2 64 64 2 64 64 2 64 64 2 64 64 2 64 64 2 64 64 2 64 64 2 64 64 2 64 64 2 64 64 2 64 64 2 64 64 2 64 64 2 64 64 2 64 64 2 64 64 2 64 64 2 64 64 2 64 64 2 64 64
2 64 64 0 64 64 0 64 64 0 64 64 0 64 64 0 64 64 0 64 64 0 64 64 0 64 64 0 64 64 0 64 64 0 64 64 0 64 64 0 64 64 0 64 64 0 64 64 0 64 64 0 64 64 0 64 64 2 64 64
2 64 64 0 64 64 2 64 64 2 64 64 2 64 64 0 64 64 0 64 64 0 64 64 0 64 64 0 64 64 0 64 64 0 64 64 0 64 64 0 64 64 0 64 64 0 64 64 0 64 64 0 64 64 0 64 64 2 64 64
2 64 64 0 64 64 2 64 64 2 64 64 2 64 64 0 64 64 0 64 64 0 64 64 0 64 64 0 64 64 0 64 64 0 64 64 0 64 64 0 64 64 0 64 64 0 64 64 0 64 64 0 64 64 0 64 64 2 64 64
2 64 64 0 64 64 2 64 64 2 64 64 2 64 64 2 64 64 2 64 64 2 64 64 2 64 64 2 64 64 2 64 64 2 64 64 2 64 64 2 64 64 2 64 64 2 64 64 2 64 64 2 64 64 0 64 64 2 64 64
2 64 64 0 64 64 0 64 64 0 64 64 0 64 64 0 64 64 0 64 64 0 64 64 0 64 64 0 64 64 0 64 64 0 64 64 0 64 64 0 64 64 0 64 64 0 64 64 0 64 64 0 64 64 0 64 64 2 64 64
2 64 64 0 64 64 0 64 64 0 64 64 0 64 64 0 64 64 0 64 64 0 64 64 0 64 64 0 64 64 0 64 64 0 64 64 0 64 64 0 64 64 0 64 64 0 64 64 0 64 64 0 64 64 0 64 64 2 64 64
2 64 64 0 64 64 0 64 64 0 64 64 0 64 64 0 64 64 0 64 64 0 64 64 0 64 64 0 64 64 0 64 64 0 64 64 0 64 64 0 64 64 0 64 64 0 64 64 0 64 64 0 64 64 0 64 64 2 64 64
2 64 64 0 64 64 0 64 64 0 64 64 0 64 64 0 64 64 0 64 64 0 64 64 0 64 64 0 64 64 0 64 64 0 64 64 0 64 64 0 64 64 0 64 64 0 64 64 0 64 64 0 64 64 0 64 64 2 64 64
2 64 64 0 64 64 0 64 64 0 64 64 0 64 64 0 64 64 0 64 64 0 64 64 0 64 64 0 64 64 0 64 64 0 64 64 0 64 64 0 64 64 0 64 64 0 64 64 0 64 64 0 64 64 0 64 64 2 64 64
2 64 64 0 64 64 0 64 64 0 64 64 0 64 64 0 64 64 0 64 64 0 64 64 0 64 64 0 64 64 0 64 64 0 64 64 0 64 64 0 64 64 0 64 64 0 64 64 0 64 64 0 64 64 0 64 64 2 64 64
2 64 64 0 64 64 0 64 64 0 64 64 0 64 64 0 64 64 0 64 64 0 64 64 0 64 64 0 64 64 0 64 64 0 64 64 0 64 64 0 64 64 0 64 64 0 64 64 0 64 64 0 64 64 0 64 64 2 64 64
2 64 64 0 64 64 0 64 64 0 64 64 0 64 64 0 64 64 0 64 64 0 64 64 0 64 64 0 64 64 0 64 64 0 64 64 0 64 64 0 64 64 0 64 64 0 64 64 0 64 64 0 64 64 0 64 64 2 64 64
2 64 64 0 64 64 0 64 64 0 64 64 0 64 64 0 64 64 0 64 64 0 64 64 0 64 64 0 64 64 0 64 64 0 64 64 0 64 64 0 64 64 0 64 64 0 64 64 0 64 64 0 64 64 0 64 64 2 64 64
2 64 64 0 64 64 0 64 64 0 64 64 0 64 64 0 64 64 0 64 64 0 64 64 0 64 64 0 64 64 0 64 64 0 64 64 0 64 64 0 64 64 0 64 64 0 64 64 0 64 64 0 64 64 0 64 64 2 64 64
2 64 64 0 64 64 0 64 64 0 64 64 0 64 64 0 64 64 0 64 64 0 64 64 0 64 64 0 64 64 0 64 64 0 64 64 0 64 64 0 64 64 0 64 64 0 64 64 0 64 64 0 64 64 0 64 64 2 64 64
2 64 64 0 64 64 0 64 64 0 64 64 0 64 64 0 64 64 0 64 64 0 64 64 0 64 64 0 64 64 0 64 64 0 64 64 0 64 64 0 64 64 0 64 64 0 64 64 0 64 64 0 64 64 0 64 64 2 64 64
2 64 64 0 64 64 0 64 64 0 64 64 0 64 64 0 64 64 0 64 64 0 64 64 0 64 64 0 64 64 0 64 64 0 64 64 0 64 64 0 64 64 0 64 64 0 64 64 0 64 64 0 64 64 0 64 64 2 64 64
2 64 64 0 64 64 0 64 64 0 64 64 0 64 64 0 64 64 0 64 64 0 64 64 0 64 64 0 64 64 0 64 64 0 64 64 0 64 64 0 64 64 0 64 64 0 64 64 0 64 64 0 64 64 0 64 64 2 64 64
2 64 64 2 64 64 2 64 64 2 64 64 2 64 64 2 64 64 2 64 64 2 64 64 2 64 64 2 64 64 2 64 64 2 64 64 2 64 64 2 64 64 2 64 64 2 64 64 2 64 64 2 64 64 2 64 64 2 64 64