0 20 20 test
0 0 0 0 0 0 0 0 0 0 0 0 0 0 0 0 0 0 0 0
0 0 1 0 1 0 1 0 1 0 1 0 1 0 1 0 1 0 1 0
0 1 0 1 0 1 0 1 0 1 0 1 0 1 0 1 0 1 0 0
0 0 1 0 1 0 1 0 1 0 1 0 1 0 1 0 1 0 1 0
0 1 0 1 0 1 0 1 0 1 0 1 0 1 0 1 0 1 0 0
0 0 1 0 1 0 1 0 1 0 1 0 1 0 1 0 1 0 1 0
0 1 0 1 0 1 0 1 0 1 0 1 0 1 0 1 0 1 0 0
0 0 1 0 1 0 1 0 1 0 1 0 1 0 1 0 1 0 1 0
0 1 0 1 0 1 0 1 0 1 0 1 0 1 0 1 0 1 0 0
0 0 1 0 1 0 1 0 1 0 1 0 1 0 1 0 1 0 1 0
0 1 0 1 0 1 0 1 0 1 0 1 0 1 0 1 0 1 0 0
0 0 1 0 1 0 1 0 1 0 1 0 1 0 1 0 1 0 1 0
0 1 0 1 0 1 0 1 0 1 0 1 0 1 0 1 0 1 0 0
0 0 1 0 1 0 1 0 1 0 1 0 1 0 1 0 1 0 1 0
0 1 0 1 0 1 0 1 0 1 0 1 0 1 0 1 0 1 0 0
0 0 1 0 1 0 1 0 1 0 1 0 1 0 1 0 1 0 1 0
0 1 0 1 0 1 0 1 0 1 0 1 0 1 0 1 0 1 0 0
0 0 1 0 1 0 1 0 1 0 1 0 1 0 1 0 1 0 1 0
0 1 0 1 0 1 0 1 0 1 0 1 0 1 0 1 0 1 0 0
0 0 0 0 0 0 0 0 0 0 0 0 0 0 0 0 0 0 0 0

5 64 64 5 64 64 5 64 64 5 64 64 5 64 64 5 64 64 5 64 64 5 64 64 5 64 64 5 64 64 5 64 64 5 64 64 5 64 64 5 64 64 5 64 64 5 64 64 5 64 64 5 64 64 5 64 64 5 64 64
5 64 64 0 64 64 0 64 64 0 64 64 0 64 64 0 64 64 0 64 64 0 64 64 0 64 64 0 64 64 0 64 64 0 64 64 0 64 64 0 64 64 0 64 64 0 64 64 0 64 64 0 64 64 0 64 64 5 64 64
5 64 64 0 64 64 5 64 64 5 64 64 5 64 64 0 64 64 0 64 64 0 64 64 0 64 64 0 64 64 0 64 64 0 64 64 0 64 64 0 64 64 0 64 64 0 64 64 0 64 64 0 64 64 0 64 64 5 64 64
5 64 64 0 64 64 5 64 64 5 64 64 5 64 64 0 64 64 0 64 64 0 64 64 0 64 64 0 64 64 0 64 64 0 64 64 0 64 64 0 64 64 0 64 64 0 64 64 0 64 64 0 64 64 0 64 64 5 64 64
5 64 64 0 64 64 5 64 64 5 64 64 5 64 64 5 64 64 5 64 64 5 64 64 5 64 64 5 64 64 5 64 64 5 64 64 5 64 64 5 64 64 5 64 64 5 64 64 5 64 64 5 64 64 0 64 64 5 64 64
5 64 64 0 64 64 0 64 64 0 64 64 0 64 64 0 64 64 0 64 64 0 64 64 0 64 64 0 64 64 0 64 64 0 64 64 0 64 64 0 64 64 0 64 64 0 64 64 0 64 64 0 64 64 0 64 64 5 64 64
5 64 64 0 64 64 0 64 64 0 64 64 0 64 64 0 64 64 0 64 64 0 64 64 0 64 64 0 64 64 0 64 64 0 64 64 0 64 64 0 64 64 0 64 64 0 64 64 0 64 64 0 64 64 0 64 64 5 64 64
5 64 64 0 64 64 0 64 64 0 64 64 0 64 64 0 64 64 0 64 64 0 64 64 0 64 64 0 64 64 0 64 64 0 64 64 0 64 64 0 64 64 0 64 64 0 64 64 0 64 64 0 64 64 0 64 64 5 64 64
5 64 64 0 64 64 0 64 64 0 64 64 0 64 64 0 64 64 0 64 64 0 64 64 0 64 64 0 64 64 0 64 64 0 64 64 0 64 64 0 64 64 0 64 64 0 64 64 0 64 64 0 64 64 0 64 64 5 64 64
5 64 64 0 64 64 0 64 64 0 64 64 0 64 64 0 64 64 0 64 64 0 64 64 0 64 64 0 64 64 0 64 64 0 64 64 0 64 64 0 64 64 0 64 64 0 64 64 0 64 64 0 64 64 0 64 64 5 64 64
5 64 64 0 64 64 0 64 64 0 64 64 0 64 64 0 64 64 0 64 64 0 64 64 0 64 64 0 64 64 0 64 64 0 64 64 0 64 64 0 64 64 0 64 64 0 64 64 0 64 64 0 64 64 0 64 64 5 64 64
5 64 64 0 64 64 0 64 64 0 64 64 0 64 64 0 64 64 0 64 64 0 64 64 0 64 64 0 64 64 0 64 64 0 64 64 0 64 64 0 64 64 0 64 64 0 64 64 0 64 64 0 64 64 0 64 64 5 64 64
5 64 64 0 64 64 0 64 64 0 64 64 0 64 64 0 64 64 0 64 64 0 64 64 0 64 64 0 64 64 0 64 64 0 64 64 0 64 64 0 64 64 0 64 64 0 64 64 0 64 64 0 64 64 0 64 64 5 64 64
5 64 64 0 64 64 0 64 64 0 64 64 0 64 64 0 64 64 0 64 64 0 64 64 0 64 64 0 64 64 0 64 64 0 64 64 0 64 64 0 64 64 0 64 64 0 64 64 0 64 64 0 64 64 0 64 64 5 64 64
5 64 64 0 64 64 0 64 64 0 64 64 0 64 64 0 64 64 0 64 64 0 64 64 0 64 64 0 64 64 0 64 64 0 64 64 0 64 64 0 64 64 0 64 64 0 64 64 0 64 64 0 64 64 0 64 64 5 64 64
5 64 64 0 64 64 0 64 64 0 64 64 0 64 64 0 64 64 0 64 64 0 64 64 0 64 64 0 64 64 0 64 64 0 64 64 0 64 64 0 64 64 0 64 64 0 64 64 0 64 64 0 64 64 0 64 64 5 64 64
5 64 64 0 64 64 0 64 64 0 64 64 0 64 64 0 64 64 0 64 64 0 64 64 0 64 64 0 64 64 0 64 64 0 64 64 0 64 64 0 64 64 0 64 64 0 64 64 0 64 64 0 64 64 0 64 64 5 64 64
5 64 64 0 64 64 0 64 64 0 64 64 0 64 64 0 64 64 0 64 64 0 64 64 0 64 64 0 64 64 0 64 64 0 64 64 0 64 64 0 64 64 0 64 64 0 64 64 0 64 64 0 64 64 0 64 64 5 64 64
5 64 64 0 64 64 0 64 64 0 64 64 0 64 64 0 64 64 0 64 64 0 64 64 0 64 64 0 64 64 0 64 64 0 64 64 0 64 64 0 64 64 0 64 64 0 64 64 0 64 64 0 64 64 0 64 64 5 64 64
5 64 64 5 64 64 5 64 64 5 64 64 5 64 64 5 64 64 5 64 64 5 64 64 5 64 64 5 64 64 5 64 64 5 64 64 5 64 64 5 64 64 5 64 64 5 64 64 5 64 64 5 64 64 5 64 64 5 64 64