0 20 20 test
0 0 0 0 0 0 0 0 0 0 0 0 0 0 0 0 0 0 0 0
0 0 1 0 1 0 1 0 1 0 1 0 1 0 1 0 1 0 1 0
0 1 0 1 0 1 0 1 0 1 0 1 0 1 0 1 0 1 0 0
0 0 1 0 1 0 1 0 1 0 1 0 1 0 1 0 1 0 1 0
0 1 0 1 0 1 0 1 0 1 0 1 0 1 0 1 0 1 0 0
0 0 1 0 1 0 1 0 1 0 1 0 1 0 1 0 1 0 1 0
0 1 0 1 0 1 0 1 0 1 0 1 0 1 0 1 0 1 0 0
0 0 1 0 1 0 1 0 1 0 1 0 1 0 1 0 1 0 1 0
0 1 0 1 0 1 0 1 0 1 0 1 0 1 0 1 0 1 0 0
0 0 1 0 1 0 1 0 1 0 1 0 1 0 1 0 1 0 1 0
0 1 0 1 0 1 0 1 0 1 0 1 0 1 0 1 0 1 0 0
0 0 1 0 1 0 1 0 1 0 1 0 1 0 1 0 1 0 1 0
0 1 0 1 0 1 0 1 0 1 0 1 0 1 0 1 0 1 0 0
0 0 1 0 1 0 1 0 1 0 1 0 1 0 1 0 1 0 1 0
0 1 0 1 0 1 0 1 0 1 0 1 0 1 0 1 0 1 0 0
0 0 1 0 1 0 1 0 1 0 1 0 1 0 1 0 1 0 1 0
0 1 0 1 0 1 0 1 0 1 0 1 0 1 0 1 0 1 0 0
0 0 1 0 1 0 1 0 1 0 1 0 1 0 1 0 1 0 1 0
0 1 0 1 0 1 0 1 0 1 0 1 0 1 0 1 0 1 0 0
0 0 0 0 0 0 0 0 0 0 0 0 0 0 0 0 0 0 0 0

2  5  2  5  2  5  2  5  2  5  2  5  2  5  2  5  2  5  2  5 
5  0  0  0  0  0  0  0  0  0  0  0  0  0  0  0  0  0  0  2 
2  0  2  5  2  0  0  0  0  0  0  0  0  0  0  0  0  0  0  5 
5  0  5  2  5  0  0  0  0  0  0  0  0  0  0  0  0  0  0  2 
2  0  2  5  2  5  2  5  2  5  0  0  2  5  2  5  2  5  0  5 
5  0  0  0  0  0  0  0  0  0  0  0  0  0  0  0  0  0  0  2 
2  0  0  0  0  0  0  0  0  0  0  0  0  0  0  0  0  0  0  5 
5  0  0  0  0  0  0  0  0  0  0  0  0  0  0  0  0  0  0  2 
2  0  0  0  0  0  0  0  0  0  0  0  0  0  0  0  0  0  0  5 
5  0  0  0  0  0  0  0  0  0  0  0  0  0  0  0  0  0  0  2 
2  0  0  0  0  0  0  0  0  0  0  0  0  0  0  0  0  0  0  5 
5  0  0  0  0  0  0  0  0  0  0  0  0  0  0  0  0  0  0  2 
2  0  0  0  0  0  0  0  0  0  0  0  0  0  0  0  0  0  0  5 
5  0  0  0  0  0  0  0  0  0  0  0  0  0  0  0  0  0  0  2 
2  0  0  0  0  0  0  0  0  0  0  0  0  0  0  0  0  0  0  5 
5  0  0  0  0  0  0  0  0  0  0  0  0  0  0  0  0  0  0  2 
2  0  0  0  0  0  0  0  0  0  0  0  0  0  0  0  0  0  0  5 
5  0  0  0  0  0  0  0  0  0  0  0  0  0  0  0  0  0  0  2 
2  0  0  0  0  0  0  0  0  0  0  0  0  0  0  0  0  0  0  5 
5  2  5  2  5  2  5  2  5  2  5  2  5  2  5  2  5  2  5  2 